5022200023200
0121012101012
0200222004022
2101210121010
0020222220000
2121012101010
0202022020202
3121010101010
0322222000004
0101012101012
4200003000222
0121012101010
0200222222206