4022200022200
0121012101012
0200222003022
2101210121010
0020222220000
2121012101010
0202022020202
2121010101010
0222222000003
0101012101012
3200002000222
0121012101010
0200222222205