5022200023200
0120022000012
0200222004022
2001200021000
0020222220000
2020012100000
0202022020202
3020010100000
0322222000004
0001002001002
4200003000222
0120002000010
0200222222206