4022200022200
0120022000012
0200222003022
2001200021000
0020222220030
2123012100010
0202022020202
2120010100010
0222222000003
0031002001002
3200002000222
0120002000010
0200222222205