5124000023000
0121012101010
0100222040024
2121012101010
0322222032000
1111001001111
0203022020202
1111001001111
0002222032200
0101012101010
0240043040210
0101012101010
0000222222216