4123000022000
0121012101010
0100222030023
2121012101010
0222222022000
1111001001111
0202022020202
1111001001111
0002222022200
0101012101010
0230033030210
0101012101010
0000222222215