1111111111111
1300001300001
1002001002001
1021201021201
1002001002001
1000030000031
1111102011111
1000000000031
1002001002001
1021201021201
1002001002001
1400001000051
1111111111111