1111111111111
1400001400001
1002001002001
1021201021201
1002001002001
1000040000041
1111103011111
1000000000041
1002001002001
1021201021201
1002001002001
1500001000061
1111111111111