3203002000305
2100022200010
0010022200100
0301011101000
0000202020000
0221022201220
2221221221222
0221022201220
0000202020300
0001011101000
0010022200100
0100022200012
4000002003022