3204002000406
2100022200010
0010023200100
0401011101000
0000202020000
0221023201220
2231231321322
0221023201220
0000202020400
0001011101000
0010023200100
0100022200012
5000002004023