4000000002222
0000000002222
0000000002222
0000000002222
0000000000000
0000000000000
0000000000000
0030003000300
0000000000000
0000000001000
0000000011100
0000000001000
060708090x005